XXX    2222XXXXXXX
X                X
X                X
                 X
X                X
X                X
     XX   X      X
X     X XX       X
X    SXX         X
X     X XX       X
X    XX   X      X
X                X
X  X             X
   X   B2        X
                 X
               H0X
X                X
XX     1111XXXXXXX
