XXXXXXX2222XXXXXXX
X              H0X
X                X
X                X
X H0             X
X                X
X    XX   XH0    X
X     X XX       X
X    SXX         X
X     X XX H0    X
X    XX   X      X
X                X
X  X             X
X  X   B2        X
X                X
X              H0X
X                X
XXXXXXX1111XXXXXXX
